Let's Logic Collection ID: 321
Title: Chrysalis Collection 02
Author: David Buchweitz
Description: The 2nd collection of 50 puzzles taken from my creations in the members section of letslogic.com - roughly in order of publish date.

#########__
#----#--#__
#.$-$#$-#__
#.#--#--#__
#.$-$#$-#__
#.#--#--#__
#.$-$#$-#__
#.#--#--#__
#.$-$#$-#__
#.#--#--#__
#.$-$#$-#__
#.#--#--#__
#.$-$#$-#__
#.#--#--###
#.$-$@$---#
#.#-#-#-#-#
#.......--#
###########
ID: 18931
Title: Elle
Author: David Buchweitz

__#####__
###---###
#-.$.$.-#
#-$---$-#
##.$+$.##
#---#---#
#-$.*.$-#
###---###
__#####__
ID: 18932
Title: 9x9x9x9
Author: David Buchweitz

_######____
##----####_
#--$$$---#_
#-.#.#.#.##
#--#------#
#----@-#--#
##$#$#$#$-#
_#---...--#
_####----##
____######_
ID: 18940
Title: In the cloud
Author: David Buchweitz

____########
____#------#
__###-####-#
###.-$-.---#
#-$-#.##$###
#-#$.+.$--#_
#---#.-##-#_
#-$.---.$-#_
###$##-$#-#_
__#-------#_
__#########_
ID: 18943
Title: Rabbit
Author: David Buchweitz

___#######___
__#-------#__
_#--##-##--#_
#--..$-$..--#
#-$..###..$-#
##-#--*--#-##
_#-$$-@-$$-#_
_##-.$$$.-##_
__##-...-##__
___##---##___
_____#.#_____
___##---##___
__#-$-.-$-#__
#_#-##-##-#_#
###-$-.-$-###
__#-##-##-#__
__#-$-.-$-#__
__#-------#__
___#######___
_____#_#_____
____##_##____
ID: 18953
Title: Mr Miagi
Author: David Buchweitz

#####_#######
#---###..---#
#-$$$.@.$$$-#
#---..###---#
##-#-##_#####
_#---#_______
_#####_______
ID: 18966
Title: Easy One
Author: David Buchweitz

__##########_##########__
###---##---###---##---###
#---$-..-$-.-.-$-..-$---#
#-#---##---#-#---##---#-#
#-##$####$##@##$####$##-#
#-#---##---#-#---##---#-#
#---$-..-$-.-.-$-..-$---#
###---##---###---##---###
__##########_##########__
ID: 18971
Title: Tetrissy
Author: David Buchweitz

_#######_
_#-----#_
_#$$$$-#_
##.#.#.##
#.-.-.-.#
####$-#-#
__#-$-$-#
__#-@-###
__#####__
ID: 18974
Title: zigzag
Author: David Buchweitz

__########
__#------#
__#$##$#-#
__#-..-#-#
__#-.----#
###--.-#-#
#-$-..-$-#
#-#$##$###
#-------@#
##########
ID: 19111
Title: Anchor
Author: David Buchweitz

#####__###
#---####-#
#-$----+-#
#-$#-##.-#
#-$-$.#.##
##.#.$-$-#
#-.##-#$-#
#-.----$-#
#-####---#
###__#####
ID: 19112
Title: Double
Author: David Buchweitz

###############
#-------------#
#-###########-#
#-#-----------#
#-#$#$#@#$#$#-#
#-$.........$-#
#-#..*.*.*..#-#
#-$$$#$$$#$$$-#
#----#--------#
###############
ID: 19114
Title: Under The Boardwalk
Author: David Buchweitz

_________####
_#########--#
_#----------#
_#-#$$$$$#--#
##-#--------#
#...####$-###
#...------#__
#...-$$$###__
#####--@#____
____#####____
ID: 19218
Title: Zuma
Author: David Buchweitz

__#####__
__#---#__
###-$-##_
#---#--##
#-$-$-$-#
#-#-#-#-#
#-$-$.*.#
###-@.#.#
__##$...#
___#--###
___####__
ID: 19222
Title: Around The Block
Author: David Buchweitz

_______######_______
_______#----#_______
_______#-#$-#_______
_______#-#--#_______
_______#-#$-####____
_____###-#..-$-#____
_____#---#.###-#____
######-###.$-#-#####
#------#...$-#-----#
#-######.$-$-..$-$-#
#-$......$@$-.####-#
#---#$$$$$-$$.#----#
###-#------$-.#-####
__#-#-$-$*.*..#-#___
__#-#-$-$.#####-#___
__#-#####.#-----#___
__#----$..#-#####___
__######-$#-#_______
_______#----#_______
_______######_______
ID: 19401
Title: Incrementor
Author: David Buchweitz

_#########___
_#-------###_
##.$-$-$.$-##
#--#####-#--#
#-$#--.#--$-#
#-.#...-.-#-#
#-$#--.##-$-#
#--#####--#-#
#-.$-$-$.$+-#
####-#-#--###
___#------#__
___########__
ID: 19402
Title: Tee
Author: David Buchweitz

___#___#___#___
__#-#_#-#_#-#__
_#---#---#---#_
#--$---$---$--#
_#---#-#-#---#_
__#-#-.-.-#-#__
_#---.-#-.---#_
#--$#-#*#-#$--#
_#---.-#-.---#_
__#-#-.-.-#-#__
_#---#-#-#---#_
#--$---$---$--#
_#---#---#---#_
__#-#_#@#_#-#__
___#___#___#___
ID: 19416
Title: 9th Symphony
Author: David Buchweitz

_#########_
##---@---##
#-$#$#$#$-#
#...$-$...#
#--#$-$#--#
#----$----#
#-$.$#$.$-#
##-.-.-.-##
_##.###.##_
__###_###__
ID: 19419
Title: Bowtie
Author: David Buchweitz

___#####__
_###.$-##_
_#-$.$--#_
##-#.$#-##
#........#
#$$$.$$$$#
#---.$---#
####.$@$##
___#.$--#_
___######_
ID: 19421
Title: Cramped Cross
Author: David Buchweitz

__#####__
__#---###
###$#-$-#
#---#.#-#
#-$-.+.-#
###-#.#-#
_#-$-.#-#
_#--$-$-#
_###--###
___####__
ID: 19422
Title: Have Mercy
Author: David Buchweitz

__#######__
_##.....##_
_#.-----.#_
##.#-@-#.#_
#-.$$$$$.##
#-$.....$-#
#-$#-#-#$-#
#-$-----$-#
###$$$$$#-#
__#-------#
__##----###
___######__
ID: 19429
Title: Interlinked
Author: David Buchweitz

##########__
#.....-*-#__
#.-$.#$$-###
#.$$..-$-.-#
#....#$$$#-#
#.#.#--$---#
#-$-$--$-###
#*$$$$$+-#__
#---$---##__
###.#-###___
__#---#_____
__#####_____
ID: 19430
Title: Octopus
Author: David Buchweitz

_____#####_
######.-@#_
#.----$-.#_
#-$#$##-##_
##----#-#__
#-.##.$-###
#-##-$#-$-#
#------.#-#
######----#
_____######
ID: 19432
Title: Basking in the sun
Author: David Buchweitz

##########
#.--.#--.#
##-#-$--##
_#-#-##$#_
_#-$-@--#_
_#-###$.#_
_#.--$-###
_##$#----#
__#---.--#
__########
ID: 19435
Title: T-Bone
Author: David Buchweitz

###########
#--#---#--#
#-$.$.$.$-#
#-.$-$-$.-#
##$-...-$##
#-.$.@.$.-#
##$-...-$##
#-.$-$-$.-#
#-$.$.$.$-#
#--#---#--#
###########
ID: 19480
Title: Fangs
Author: David Buchweitz

______###########____
______#---------#____
__#####-#######-###__
__#---$-$-----$-$-#__
###-###-#####-#-#-###
#-----$-$-----$-$---#
#-#$#$#-#####.#-#$#-#
#-#-----......#---#-#
#-#$#$#-#####.#-#$#-#
#-------...@#.#-----#
#-#$#$#-#.###.#-#$#-#
#-#-----#......---#-#
#-#$#$#-#.#####-#$#-#
#-------.......-----#
###-#-#-#-#####-#-#-#
__#-#-$-$-----$-$-#-#
__#-###-#####-#-###-#
__#---$-$-----$-$---#
__#####-#######-#####
______#---------#____
______###########____
ID: 21896
Title: Whirlpool
Author: David Buchweitz

#############
#..---------#
#.#.$-$#-##-#
#-.#.$-$-.#-#
#-$.#.$-$-#-#
#--$.#.$-$#-#
#-$-$.@.$-$-#
#-#$-$.#.$--#
#---$-$.#.$-#
###.-$-$.#.-#
__##-#$-$.#.#
___#------..#
___##########
ID: 21898
Title: Diagonal
Author: David Buchweitz

#################################
#-------------------------------#
#-***.-*--.-***.-*--.-***.-***.-#
#-*----*--*-*--*-*-*--*----*----#
#-*----*--*-*--*-*-*--*----*----#
#-****-**-*-*--*@**---***--****-#
#----*-*-**-****-*-*--*-------*-#
#----*-*--*-*--*-*-*--*-------*-#
#-$***-$--*-$--*-$--*-$***-$***-#
#-------------------------------#
#################################
ID: 21907
Title: Snakes
Author: David Buchweitz

_________######______
_________#----####___
________##-##----#___
____#####---####-#___
___##-----$----#-#___
__##--##-$####-#-#___
_##--##-$--#_#-#-#___
##--##-$-#-#_#-#-#___
#--##-$--@-#_#-#-#___
#-##-$-###-#_#-#-#___
#-#-$--#_#-#_#-#-#___
#-#$-#-#_#-#_#-#-##__
#-#.---#_#-#_#-#--#__
#-##.#-###-#_#-##-#__
#--##.-----#_#--#-#__
##--#-.#-#-####-#-#__
_##---#.--------#-#__
__######.#--#####-#__
_______#-.--#-----#__
_______#-#.##-#####__
_______#-###--#______
_______#-----##______
_______#######_______
ID: 21908
Title: Which Path?
Author: David Buchweitz

__###########
__#-----#---#
_##$#-$-.-#-#
_#--.-#-###-#
_#--#-#-#---#
###$#.@.#$###
#---#-#-#--#_
#-###-#-.--#_
#-#-.-$-#$##_
#---#-----#__
###########__
ID: 21909
Title: Slinky
Author: David Buchweitz

_###################_
##.................##
#.#-------#-------#.#
#.-#$$$$$$$$$$$$$#-.#
#.-$-#----#------$-.#
#.-$-####-####-##$-.#
#.-$-----------#-$-.#
#.-$-#-$$$$$$.-#-$-.#
#.-$-#-$-----$-#-$-.#
#.-$-#-$-$..-$---$-.#
#.#$##-$-.@.-$-##$#.#
#.-$---$-..$-$-#-$-.#
#.-$-#-$-----$-#-$-.#
#.-$-#-.$$$$$$-#-$-.#
#.-$-#-----------$-.#
#.-$##-####-####-$-.#
#.-$------#----#-$-.#
#.-#$$$$$$$$$$$$$#-.#
#.#-------#-------#.#
##.................##
_###################_
ID: 21910
Title: Catherine Wheel
Author: David Buchweitz

#######################
#---------------------#
#-*...$....$....$...*-#
#-.$$$$.$$.$.$$*$.$$$-#
#-*$---....$....$...$-#
#-.$$$$.$$.$.$$-$.$$$-#
#-....$.$-.$.$--$....-#
#-$$$$$$$$$$$$$$$$$$$-#
#-....$....$.$-.$.$-.-#
#-$..$$.$$.$.$$.$.$$.-#
#-$..$-.@$.$.-$.$..$.-#
#-$..$-.$$.$....$.$..-#
#-$..$$....$$..$$.$$.-#
#---------------------#
#######################
___##_____________##___
___##_____________##___
__####___________####__
__####___________####__
ID: 21911
Title: Welcome to...
Author: David Buchweitz

##########_
#--$---.-#_
#-$#$#.#.#_
#--$---.-#_
##-#-@-#-##
_#-.---$--#
_#.#.#$#$-#
_#-.---$--#
_##########
ID: 21912
Title: 4x4 skewed
Author: David Buchweitz

_____#####_____
######-@-######
#--$---.---$--#
#-$#$#.#.#$#$-#
#--$---.---$--#
##-###-#-###-##
_#-.---$---.-#_
_#.#.#$#$#.#.#_
_#-.---$---.-#_
_###-#####-###_
___#-------#___
___#########___
ID: 21913
Title: 6x4
Author: David Buchweitz

########___
#------###_
##$#$#-#.#_
#--$-.-.-#_
#-$#$#.#.##
#--$-$-.-.#
#-$#.@.#$-#
#.-.-$-$--#
##.#.#$#$-#
_#-.-.-$--#
_#.#-#$#$##
_###------#
___########
ID: 21914
Title: Shuriken
Author: David Buchweitz

____####______
____#--#______
____#-$#______
#####--####___
#----$-$--#___
#--$.....$#___
###$.#-#.-####
__#-.#+-.$---#
__#-.#-#.--$-#
###$.*.*.$####
#--$-$-$--#___
#-$-####$-#___
#---#__#--#___
#####__####___
ID: 21915
Title: Puzzler
Author: David Buchweitz

######___________######____
#----#############----#____
#-##---------------##-#____
#-#--#############----#____
#----#___________#--#-#____
##.#$#___________##.#$##___
_#-#-#############---.-#___
_#-.----------------##-#___
_#-##-#############--$-#___
_#-$--#___________#--#-#___
_##.#$#___________##.#$##__
__#-#-#############---.-#__
__#-.--------@-------##-#__
__#-##-#############--$-#__
__#-$--#___________#--#-#__
__##.#$#___________##.#$##_
___#-#-#############---.-#_
___#-.----------------##-#_
___#-##-#############--$-#_
___#-$--#___________#--#-#_
___##.#$#___________##.#$##
____#-#-#############-----#
____#-------------------#-#
____#-##-#############-##-#
____#----#___________#----#
____######___________######
ID: 21966
Title: Riser
Author: David Buchweitz

___#####____
####--@#####
#--.$#-----#
#-$--.$#-#-#
#--.$#-.$--#
###--.$--#-#
__#####.---#
______######
ID: 21967
Title: Quicky
Author: David Buchweitz

_#############_
_#-----------#_
_#-#########-##
##-#-------#--#
#--#.$$.$$.##-#
#-##$..$..$---#
#---.$$.$$.-###
###-$..$..$---#
#---.$$.$$.##-#
#-##$..$..$#--#
#--#---@---#-##
##-#########-#_
_#-----------#_
_#############_
ID: 21969
Title: Cargo Net with Training Wheels
Author: David Buchweitz

_#########_
_#-------#_
_#.$$.$$.##
##$..$..$-#
#-.$$.$$.-#
#-$..$..$-#
#-.$$.$$.##
##$..$..$#_
_#---@---#_
_#########_
ID: 21968
Title: Cargo Net
Author: David Buchweitz

#######__
#...--##_
#.#.---##
#...-#--#
#--#$$$-#
##--$@$-#
_###$$$##
_#-----#_
_#-#-###_
_#---#___
_#####___
ID: 23531
Title: Ear
Author: David Buchweitz

__#######__
_#-------#_
#-@#$$#$-#_
_#-$-..$-#_
__#--..-#__
___##..###_
#__#-..-$-#
_###-#$$#-#
___#------#
____######_
_____#__#__
____##_##__
ID: 23672
Title: Here Boy
Author: David Buchweitz

___######_
___#----#_
_###$$#-#_
##-.--.-#_
#--#$$###_
#--$.-#___
#--#$.###_
##.#--.-#_
_#-.--#.##
_###.$#--#
___#-.$--#
_###$$#--#
_#-+--#-##
_#-#$$.-#_
_#----###_
_######___
ID: 23673
Title: Passage with Bridge
Author: David Buchweitz

#####__####
#----##---#
#-$.$#--@-#
#-.$.$.$--#
#-$.-.$.-#_
_##$.#.$##_
_#-.$.-.$-#
#--$.$.$.-#
#-#--#$.$-#
#---##----#
####__#####
ID: 23674
Title: Rotary
Author: David Buchweitz

___#########_
___#-------#_
__##$#$#$#-#_
###--@-----#_
#-$$$#-#-#-#_
#-$--$$$-#-#_
#-##-#-#-#-#_
#..........##
#######-##--#
______#-----#
______#--####
______####___
ID: 23679
Title: Wacky Wednesday
Author: David Buchweitz

#######_
#-----##
#-$-$--#
##$#$#-#
#...$--#
#..-#-##
###-@-#_
__#####_
ID: 23681
Title: Fiver
Author: David Buchweitz

____#####_
#####-@-#_
#---#-#-#_
#---$-$-##
##$#.##--#
#--#...$-#
#-$...#--#
#--##.#$##
##-$-$--#_
_#-#----#_
_#-####-#_
_#------#_
_########_
ID: 23783
Title: Center Shuriken
Author: David Buchweitz

###########
#-$-.#.-$-#
#--$.$.$--#
#-$-.#.-$##
#--$.*.$-#_
##$-.#.-$#_
_#-$.+.$-#_
_#$-.#.-$##
_#-$.*.$--#
##$-.#.-$-#
#--$.*.$--#
#-$-.#.-$-#
###########
ID: 23784
Title: Broken Ladder
Author: David Buchweitz

#####__####___
#---####--#___
#-$----$$-####
##$#$-##-----#
_#--$-$--###-#
_##.#+$.$#_#-#
_#..#.$..###-#
_#.$-#-#.----#
_#.$----.-##-#
_##-####--#--#
_#-----####-##
_#####------#_
_____########_
ID: 23785
Title: Handlebars
Author: David Buchweitz

#####_######
#---###----#
#-$-----$$-#
###-$-#@-$##
__###-$$--#_
_##.###--$##
##..#.#$-$-#
#.-...-$---#
#..--.###--#
####--#_####
___#--#_____
___####_____
ID: 23786
Title: Puzzler II
Author: David Buchweitz

####_#####
#-@###.*.#
#-$---.-.#
#----#-$##
##$#-$--#_
_#--$-#$##
##$-#----#
#.-.---$-#
#.*.###--#
#####_####
ID: 23787
Title: Corner Camper
Author: David Buchweitz